一並=一併
一出=一齣
一只=一隻
一地裏=一地裡
一沖=一衝
七只=七隻
三元裏=三元裡
三只=三隻
三復=三複
三極管=三極體
上載=上傳
下面=下麵
不舍=不捨
不銹鋼=不鏽鋼
世界杯=世界盃
並入=併入
並列=併列
並到=併到
並合=併合
並吞=併吞
並在=併在
並成=併成
並排=併排
並攏=併攏
並案=併案
並為=併為
並發=併發
並科=併科
並購=併購
並進=併進
串行=串列
九只=九隻
亂發=亂髮
了如=瞭如
了望=瞭望
了然=瞭然
了若指掌=瞭若指掌
了解=瞭解
二極管=二極體
互聯網=網際網路
五出=五齣
五只=五隻
五行生克=五行生剋
五谷=五穀
井裏=井裡
交互式=互動式
人工智能=人工智慧
什錦面=什錦麵
以太網=乙太網
任意球=自由球
仿制=仿製
仿真=模擬
位圖=點陣圖
佛得角=維德角
來復=來複
例程=常式
供制=供製
侵並=侵併
便攜式=攜帶型
保安=保全
信息論=資訊理論
信道=通道
修復=修複
修胡刀=修鬍刀
俯沖=俯衝
個裏=個裡
借以=藉以
借借=藉藉
借助=藉助
借口=藉口
借故=藉故
借機=藉機
借此=藉此
借由=藉由
借端=藉端
借著=藉著
借詞=藉詞
借資=藉資
借酒澆愁=藉酒澆愁
假發=假髮
停制=停製
傳布=傳佈
傳感=感測
傻裏傻氣=傻裡傻氣
傾復=傾覆
儀表=儀錶
億只=億隻
優先級=優先順序
元音=母音
光標=遊標
光盤=光碟
光驅=光碟機
克制=剋制
克復=克複
克扣=剋扣
克日=剋日
克星=剋星
克服=剋服
克期=剋期
克死=剋死
克薄=剋薄
克裏=克裡
入球=進球
內制=內製
全角=全形
兩只=兩隻
八只=八隻
八字胡=八字鬍
公共汽車=公車
公布=公佈
公歷=西曆
公裏=公裡
六出=六齣
六只=六隻
六谷=六穀
共享=共用
兼並=兼併
兼容=相容
冬冬=鼕鼕
冷菜=冷盤
凡高=梵谷
凹洞裏=凹洞裡
出租車=計程車
函復=函覆
刀削面=刀削麵
分布=分佈
分布式=分散式
分辨率=解析度
切面=切麵
刊布=刊佈
別只=別隻
別扭=彆扭
別拗=彆拗
別氣=彆氣
別腳=彆腳
別致=別緻
別著=彆著
刮了=颳了
刮倒=颳倒
刮去=颳去
刮得=颳得
刮胡刀=刮鬍刀
刮著=颳著
刮走=颳走
刮起=颳起
刮風=颳風
制件=製件
制作=製作
制做=製做
制備=製備
制冰=製冰
制冷=製冷
制劑=製劑
制品=製品
制圖=製圖
制成=製成
制法=製法
制為=製為
制片=製片
制版=製版
制程=製程
制糖=製糖
制紙=製紙
制藥=製藥
制表=製表
制裁=製裁
制造=製造
制革=製革
制鞋=製鞋
制鹽=製鹽
剃發=剃髮
剃須=剃鬚
削發=削髮
前綴=首碼
前車之復=前車之覆
剛才=剛纔
剝制=剝製
剪發=剪髮
割舍=割捨
創制=創製
創獲=創穫
加蓬=加彭
加裏寧=加裡寧
加載=載入
勞力士表=勞力士錶
包谷=包穀
匏系=匏繫
北回=北迴
匡復=匡複
匯刊=彙刊
匯報=彙報
匯整=彙整
匯算=彙算
匯編=彙編
匯總=彙總
匯纂=彙纂
匯輯=彙輯
匯集=彙集
十出=十齣
十只=十隻
千只=千隻
千回百折=千迴百折
千回百轉=千迴百轉
千百只=千百隻
千鈞一發=千鈞一髮
半只=半隻
半角=半形
南回=南迴
卡裏=卡裡
印制=印製
即食麵=速食麵
卷土重來=捲土重來
卷發=卷髮
卷須=卷鬚
厄瓜多爾=厄瓜多
厄立特裏亞=厄利垂亞
反復=反覆
反沖=反衝
取舍=取捨
口裏=口裡
古柯鹹=古柯鹼
只字=隻字
只影=隻影
只手遮天=隻手遮天
只沖=只衝
只眼=隻眼
只言片語=隻言片語
只身=隻身
叮當=叮噹
可緊可松=可緊可鬆
吃裏扒外=吃裡扒外
吃裏爬外=吃裡爬外
合並=合併
名表=名錶
向導=嚮導
向往=嚮往
向應=嚮應
向日=嚮日
向邇=嚮邇
吞並=吞併
吹發=吹髮
呆裏呆氣=呆裡呆氣
周而復始=周而複始
和面=和麵
哪裏=哪裡
哭臟=哭髒
單只=單隻
嘴裏=嘴裡
噪聲=雜訊
嚕蘇=嚕囌
嚴復=嚴複
囉蘇=囉囌
四出=四齣
四只=四隻
四舍五入=四捨五入
回光返照=迴光返照
回向=迴向
回圈=迴圈
回廊=迴廊
回形夾=迴形夾
回復=回覆
回文=迴文
回旋=迴旋
回歷新年=回曆新年
回流=迴流
回環=迴環
回盪=迴盪
回紋針=迴紋針
回繞=迴繞
回翔=迴翔
回腸=迴腸
回蕩=迴蕩
回誦=迴誦
回路=迴路
回轉=迴轉
回遞性=迴遞性
回避=迴避
回鑾=迴鑾
回音=迴音
回響=迴響
回風=迴風
回首=迴首
因子=因數
因特網=網際網路
困乏=睏乏
困倦=睏倦
圈子裏=圈子裡
圈裏=圈裡
國歷=國曆
園裏=園裡
圖瓦盧=吐瓦魯
圖裏=圖裡
團子=糰子
土制=土製
土裏=土裡
在線=線上
圭亞那=蓋亞那
坑裏=坑裡
坦桑尼亞=坦尚尼亞
垂發=垂髮
埃塞俄比亞=衣索比亞
埃榮沖=埃榮衝
埋布=埋佈
城裏=城裡
域名=功能變數名稱
報復=報複
墻裏=牆裡
墾復=墾複
壇壇罐罐=罈罈罐罐
壇子=罈子
壺裏=壺裡
壽面=壽麵
夏天裏=夏天裡
夏歷=夏曆
外制=外製
多沖=多衝
夜光表=夜光錶
夜裏=夜裡
夢裏=夢裡
大只=大隻
天翻地復=天翻地覆
奏折=奏摺
#奔馳=賓士
奶酪=乳酪
好困=好睏
字匯=字彙
字庫=字型檔
字段=欄位
字符=字元
字節=位元組
字號=字型大小
字裏行間=字裡行間
存折=存摺
存盤=存檔
定制=定製
宣佈=宣布
宮裏=宮裡
家俱=傢俱
家裏=家裡
密布=密佈
密致=密緻
寫保護=防寫
寬帶=寬頻
寬松=寬鬆
寶裏寶氣=寶裡寶氣
封面裏=封面裡
尋址=定址
對表=對錶
小只=小隻
就裏=就裡
局域網=區域網
局裏=局裡
居裏=居裡
屋子裏=屋子裡
屋裏=屋裡
展布=展佈
屯裏=屯裡
山裏=山裡
山重水復=山重水複
岡比亞=甘比亞
峰回=峰迴
巔復=巔覆
巡回=巡迴
巨商=鉅賈
巴士=公車
尾註=章節附註
巴裏=巴裡
巷裏=巷裡
市裏=市裡
佈告=布告
布崗=佈崗
布景=佈景
布有=佈有
布殊=布希
布滿=佈滿
布線=佈線
布置=佈置
布署=佈署
布谷=布穀
布道=佈道
布達=佈達
布防=佈防
布陣=佈陣
布隆迪=蒲隆地
布雷=佈雷
帕勞=帛琉
帶發修行=帶髮修行
平治=賓士
年歷=年曆
年裏=年裡
幹系=幹係
幹絲=乾絲
幹面=乾麵
幾出=幾齣
幾只=幾隻
底裏=底裡
店裏=店裡
廟裏=廟裡
弄臟=弄髒
弘歷=弘曆
彈子臺=彈子檯
彈珠臺=彈珠檯
彈藥=彈葯
彌漫=瀰漫
彌漫著=瀰漫著
形單影只=形單影隻
往復=往複
往裏=往裡
後綴=尾碼
從裏到外=從裡到外
從裏向外=從裡向外
復上=覆上
復亡=覆亡
復仞年如=複仞年如
復以百萬=複以百萬
復位=複位
復住=覆住
復信=覆信
復冒=覆冒
復分數=複分數
復列=複列
復判=覆判
復利=複利
復制=複製
復印=複印
復原=複原
復句=複句
復合=複合
復名=複名
復命=覆命
復員=複員
復在=覆在
復壁=複壁
復壯=複壯
復姓=複姓
復字鍵=複字鍵
復審=覆審
復寫=覆寫
復巢=覆巢
復式=複式
復復=複復
復成=覆成
復敗=覆敗
復數=複數
復文=覆文
復本=複本
復查=複查
復校=覆校
復核=覆核
復檢=複檢
復次=複次
復比=複比
復水難收=覆水難收
復決=複決
復沒=覆沒
復活=複活
復測=複測
復滅=覆滅
復畝珍=複畝珍
復疊=覆疊
復發=複發
復盆=覆盆
復目=複目
復眼=複眼
復種=複種
復線=複線
復習=複習
復興社=複興社
復舊=複舊
復舟=覆舟
復色=複色
復葉=複葉
復著=覆著
復蓋=覆蓋
復蓋著=覆蓋著
復蘇=複蘇
復診=複診
復評=複評
復詞=複詞
復試=覆試
復誦=覆誦
復課=複課
復議=覆議
復變函數=複變函數
復賽=複賽
復車=覆車
復載=覆載
復轍=覆轍
復述=覆述
復選=覆選
復錢=複錢
復閱=複閱
復雜=複雜
復電=覆電
復音=複音
復韻=複韻
復鼎金=覆鼎金
循環=迴圈
心裏=心裡
忙裏=忙裡
快沖=快衝
快速面=速食麵
急沖而下=急衝而下
怪裏怪氣=怪裡怪氣
情有所鐘=情有所鍾
情有獨鐘=情有獨鍾
惡心=噁心
意面=意麵
慌裏慌張=慌裡慌張
慰借=慰藉
憑借=憑藉
憑借著=憑藉著
懷表=懷錶
懷裏=懷裡
戴表=戴錶
房裏=房裡
手折=手摺
手松=手鬆
手表=手錶
手裏=手裡
手電=手電筒
打印=列印
打印機=印表機
打谷=打穀
打門=射門
批復=批覆
承制=承製
折合=摺合
折奏=摺奏
折子=摺子
折尺=摺尺
折扇=摺扇
折梯=摺梯
折椅=摺椅
折沖=折衝
折疊=摺疊
折痕=摺痕
折篷=摺篷
折紙=摺紙
折裙=摺裙
披復=披覆
披發=披髮
拈須=拈鬚
拉纖=拉縴
拉面=拉麵
拗別=拗彆
括號=括弧
捲發=捲髮
捵面=捵麵
掃瞄儀=掃瞄器
排骨面=排骨麵
掛面=掛麵
接口=介面
控件=控制項
換只=換隻
換發=換髮
握發=握髮
撒布=撒佈
撚須=撚鬚
撞球臺=撞球檯
擔仔面=擔仔麵
擔擔面=擔擔麵
擢發難數=擢髮難數
擺布=擺佈
攝制=攝製
收獲=收穫
改制=改製
攻克=攻剋
放松=放鬆
故布疑陣=故佈疑陣
散布=散佈
散發=散髮
整出=整齣
整只=整隻
數據庫=資料庫
數碼=數位
文借=文藉
新歷=新曆
斷發=斷髮
方便面=速食麵
#方才=方纔
施舍=施捨
旋回=旋迴
族裏=族裡
日歷=日曆
明了=明瞭
明裏=明裡
星歷=星曆
星辰表=星辰錶
春假裏=春假裡
春天裏=春天裡
景致=景緻
暗地裏=暗地裡
暗溝裏=暗溝裡
暗裏=暗裡
會裏=會裡
月歷=月曆
有只=有隻
服務器=伺服器
木制=木製
硃唇皓齒=朱唇皓齒
朱批=硃批
朱砂=硃砂
朱筆=硃筆
朱紅色=硃紅色
朱色=硃色
朱諭=硃諭
村裏=村裡
束發=束髮
杯面=杯麵
松了=鬆了
松些=鬆些
松勁=鬆勁
松動=鬆動
松口=鬆口
松土=鬆土
松弛=鬆弛
松快=鬆快
松懈=鬆懈
松手=鬆手
松掉=鬆掉
松散=鬆散
松松=鬆鬆
松林=鬆林
松柔=鬆柔
松毛蟲=鬆毛蟲
松浮=鬆浮
松濤=鬆濤
松科=鬆科
松節油=鬆節油
松綁=鬆綁
松緊=鬆緊
松緩=鬆緩
松脆=鬆脆
松脫=鬆脫
松起=鬆起
松軟=鬆軟
松通=鬆通
松開=鬆開
松餅=鬆餅
枕借=枕藉
某只=某隻
染發=染髮
核復=核覆
格林納達=格瑞那達
格裏=格裡
格魯吉亞=喬治亞
桌球=撞球
梯沖=梯衝
械系=械繫
梵蒂岡=教廷
棉制=棉製
植發=植髮
標致=標緻
模制=模製
機械人=機器人
橫沖=橫衝
檢復=檢覆
權限=許可權
欺蒙=欺矇
歐幾裏得=歐幾裡得
武松=武鬆
歷數=曆數
歷書=曆書
歷法=曆法
歷象=曆象
歸並=歸併
死裏求生=死裡求生
死裏逃生=死裡逃生
殼裏=殼裡
每只=每隻
毛發=毛髮
毛裏塔尼亞=茅利塔尼亞
毛裏求斯=模裏西斯
毛裏裘斯=模裏西斯
毫發=毫髮
水表=水錶
水裏=水裡
永歷=永曆
汙蔑=汙衊
侮衊=侮蔑
池裏=池裡
沖上=衝上
沖下=衝下
沖來=衝來
沖倒=衝倒
沖克=衝剋
沖冠=衝冠
沖出=衝出
沖到=衝到
沖刺=衝刺
沖力=衝力
沖勁=衝勁
沖動=衝動
沖去=衝去
沖口=衝口
沖垮=衝垮
沖堂=衝堂
沖壓=衝壓
沖天=衝天
沖掉=衝掉
沖撞=衝撞
沖擊=衝擊
沖散=衝散
沖決=衝決
沖沖=衝衝
沖浪=衝浪
沖激=衝激
沖破=衝破
沖程=衝程
沖突=衝突
沖線=衝線
沖著=衝著
沖要=衝要
沖起=衝起
沖進=衝進
沖過=衝過
沖鋒=衝鋒
沙裏淘金=沙裡淘金
河裏=河裡
油面=油麵
泡制=泡製
泡面=泡麵
洗發=洗髮
流動電話=行動電話
浪琴表=浪琴錶
海裏=海裡
液晶表=液晶錶
涼菜=冷盤
涼面=涼麵
淡朱=淡硃
渠沖=渠衝
港制=港製
湖裏=湖裡
湯團=湯糰
湯面=湯麵
滿布=滿佈
漓江=灕江
潛意識裏=潛意識裡
潭裏=潭裡
濃發=濃髮
濕地松=濕地鬆
火並=火併
火鍋蓋帽=蓋火鍋
灰蒙=灰濛
炒面=炒麵
炮制=炮製
炸藥=炸葯
炸醬面=炸醬麵
烏發=烏髮
烏蘇裏江=烏蘇裡江
烏龍面=烏龍麵
烘制=烘製
煉制=煉製
燎發=燎髮
燙發=燙髮
燙面=燙麵
片言只語=片言隻語
牛只=牛隻
牛肉面=牛肉麵
特制=特製
特立尼達和多巴哥=千裏達托貝哥
特立尼達和托巴哥=千裏達托貝哥
特裏=特裡
牽系=牽繫
狄安娜=黛安娜
狼借=狼藉
猛沖=猛衝
獎杯=獎盃
班裏=班裡
理發=理髮
瑙魯=諾魯
瓦努阿圖=萬那杜
甜面醬=甜麵醬
生力面=生力麵
生發=生髮
生銹=生鏽
田裏=田裡
由表及裏=由表及裡
由餘=由余
男用表=男用錶
留發=留髮
異步=非同步
當啷=噹啷
當當=噹噹
疏松=疏鬆
疑系=疑係
疲困=疲睏
發型=髮型
發夾=髮夾
發妻=髮妻
發姐=髮姐
發布=發佈
發帶=髮帶
發廊=髮廊
發式=髮式
發指=髮指
發捲=髮捲
發根=髮根
發毛=髮毛
發油=髮油
發狀=髮狀
發短心長=髮短心長
發端=髮端
發結=髮結
發絲=髮絲
發網=髮網
發膚=髮膚
發膠=髮膠
發菜=髮菜
發蒙=發矇
發蠟=髮蠟
發辮=髮辮
發針=髮針
發長=髮長
發際=髮際
發雕=髮雕
發霜=髮霜
發面=發麵
發髻=髮髻
發鬢=髮鬢
白發=白髮
白裏透紅=白裡透紅
白面=白麵
百只=百隻
百裏=百裡
百谷=百穀
的士=計程車
皇歷=皇曆
皓發=皓髮
皮制=皮製
皮裏春秋=皮裡春秋
皺折=皺摺
盒裏=盒裡
盡先=儘先
盡其所有=儘其所有
盡力=儘力
盡可能=儘可能
盡快=儘快
盡早=儘早
盡是=儘是
盡盡=儘儘
盡管=儘管
盡速=儘速
盡量=儘量
監制=監製
盤回=盤迴
盤片=碟片
盤裏=盤裡
盧旺達=盧安達
直沖=直衝
相克=相剋
相沖=相衝
眼眶裏=眼眶裡
眼裏=眼裡
瞳蒙=瞳矇
短信=簡訊
短發=短髮
短訊=簡訊
石英表=石英錶
石蒓=石蓴
研制=研製
砰當=砰噹
硬件=硬體
硬盤=硬碟
磁制=磁製
磁盤=磁碟
磁道=磁軌
磨制=磨製
示復=示覆
社裏=社裡
福士=福斯
禿發=禿髮
秀發=秀髮
私下裏=私下裡
秋千=鞦韆
秋天裏=秋天裡
科摩羅=葛摩
科特迪瓦=象牙海岸
秒表=秒錶
移動電話=行動電話
稀松=稀鬆
程序=程式
程控=程式控制
稟復=稟覆
稻谷=稻穀
積架=捷豹
積谷防饑=積穀防饑
空蒙=空濛
穿梭機=太空梭
突尼斯=突尼西亞
窗口=視窗
窗明幾凈=窗明幾淨
窩裏=窩裡
窮發=窮髮
端口=埠
笑裏藏刀=笑裡藏刀
答復=答覆
算子=運算元
算歷=算曆
算法=演算法
粒入球=顆進球
粗制=粗製
精制=精製
精致=精緻
糊裏糊塗=糊裡糊塗
系上=繫上
系世=繫世
系到=繫到
系囚=繫囚
系心=繫心
系念=繫念
系懷=繫懷
系戀=繫戀
系數=繫數
系於=繫於
系為=係為
系系=繫系
系累=繫纍
系結=繫結
系緊=繫緊
系繩=繫繩
系著=繫著
系裏=系裡
系辭=繫辭
系風捕影=繫風捕影
紀歷=紀曆
紅發=紅髮
紅繩系足=紅繩繫足
紆回=紆迴
素發=素髮
素面=素麵
素食面=素食麵
累囚=纍囚
累累=纍纍
細致=細緻
組裏=組裡
結發=結髮
綁緊跳=笨豬跳
維系=維繫
綰發=綰髮
網絡=網路
網裏=網裡
編制=編製
編發=編髮
緩沖=緩衝
縈回=縈迴
縣裏=縣裡
縫制=縫製
縫裏=縫裡
總線=匯流排
繁復=繁複
繪制=繪製
纖夫=縴夫
纖手=縴手
缺省=預設
羈系=羈繫
美制=美製
美發=美髮
習用=慣用
翻來復去=翻來覆去
翻天復地=翻天覆地
翻復=翻覆
翻雲復雨=翻雲覆雨
老撾=寮國
老板=老闆
耕獲=耕穫
聯系=聯繫
聲卡=音效卡
肉松=肉鬆
肉絲面=肉絲麵
肉羹面=肉羹麵
肚裏=肚裡
胃裏=胃裡
背地裏=背地裡
胡同=衚衕
胡子=鬍子
胡梢=鬍梢
胡渣=鬍渣
胡裏胡塗=胡裡胡塗
胡須=鬍鬚
胡髭=鬍髭
脈沖=脈衝
脫機=離線
脫發=脫髮
腦子裏=腦子裡
腰裏=腰裡
膨松=膨鬆
臟亂=髒亂
臟了=髒了
臟兮兮=髒兮兮
臟字=髒字
臟得=髒得
臟東西=髒東西
臟水=髒水
臟的=髒的
臟話=髒話
臟錢=髒錢
自制=自製
致密=緻密
臺制=臺製
臺子=檯子
臺布=檯布
臺球=撞球
臺風=颱風
舂谷=舂穀
興致=興緻
舊歷=舊曆
舍不得=捨不得
舍出=捨出
舍去=捨去
舍命=捨命
舍得=捨得
舍棄=捨棄
舍生=捨生
舍身=捨身
航天飛機=太空梭
航海歷=航海曆
船只=船隻
艦只=艦隻
芯片=晶元
花盆裏=花盆裡
苑裏=苑裡
草叢裏=草叢裡
莊裏=莊裡
華發=華髮
華裏=華裡
萬只=萬隻
萬歷=萬曆
落發=落髮
蒙住=矇住
蒙懂=懞懂
蒙昧無知=矇昧無知
蒙混=矇混
蒙眬=矇矓
蒙蒙=矇矇
蒙蔽=矇蔽
蒙霧=濛霧
蒙騙=矇騙
蒙鴻=濛鴻
蓄發=蓄髮
蓄須=蓄鬚
蓬松=蓬鬆
蓬發=蓬髮
薙發=薙髮
薯仔=蕃薯 #改
藤制=藤製
蘇裏南=蘇利南
蘊借=蘊藉
虎須=虎鬚
蜜裏調油=蜜裡調油
行事歷=行事曆
衞生=衛生
表帶=錶帶
表店=錶店
表廠=錶廠
表殼=錶殼
表裏=表裡
表鏈=錶鏈
袋裏=袋裡
袖裏=袖裡
被復=被覆
被復著=被覆著
被發=被髮
被裏=被裡
裁並=裁併
裁制=裁製
裏人=裡人
裏加=裡加
裏外=裡外
裏子=裡子
裏屋=裡屋
裏層=裡層
裏布=裡布
裏帶=裡帶
裏弦=裡弦
裏應外合=裡應外合
裏拉=裡拉
裏斯=裡斯
裏海=裡海
裏程表=裏程錶
裏脊=裡脊
裏衣=裡衣
裏裏=裡裡
裏通外國=裡通外國
裏通外敵=裡通外敵
裏邊=裡邊
裏間=裡間
裏面=裡面
裏頭=裡頭
襯裏=襯裡
西歷=西曆
要沖=要衝
見復=見覆
角落裏=角落裡
觸須=觸鬚
訂制=訂製
詞匯=辭彙
詞組=片語
試制=試製
話裏有話=話裡有話
語匯=語彙
誣蔑=誣衊
調制=調製
調制解調器=數據機
譯碼=解碼
護發=護髮
變量=變數
谷人=穀人
谷保家商=穀保家商
谷倉=穀倉
谷場=穀場
谷子=穀子
谷梁=穀梁
谷殼=穀殼
谷物=穀物
谷皮=穀皮
谷神=穀神
谷粒=穀粒
谷艙=穀艙
谷苗=穀苗
谷草=穀草
谷谷=穀穀
谷賤傷農=穀賤傷農
谷道=穀道
谷雨=穀雨
谷類=穀類
谷風=穀風
象征著=象徵著
貝寧=貝南
賜復=賜覆
賭臺=賭檯
購並=購併
赤松=赤鬆
赤繩系足=赤繩繫足
赫拉=希拉
起復=起複
超級杯=超級盃
趕制=趕製
跳表=跳錶
蹈借=蹈藉
蹦極跳=笨豬跳
車庫裏=車庫裡
車站裏=車站裡
車裏=車裡
軟件=軟體
軟驅=軟碟機
輕松=輕鬆
輪回=輪迴
轉臺=轉檯
辦公臺=辦公檯
辭匯=辭彙
農歷=農曆
迂回=迂迴
近日裏=近日裡
迥然回異=迥然迴異
迷蒙=迷濛
這只=這隻
這裏=這裡
通心面=通心麵
速食面=速食麵
連系=連繫
進制=進位
遍布=遍佈
遞回=遞迴
適才=適纔
遮復=遮覆
還沖=還衝
邋裏邋遢=邋裡邋遢
那只=那隻
那裏=那裡
郁郁=鬱郁
鄉裏=鄉裡
鄰裏=鄰裡
配制=配製
酒壇=酒罈
酒杯=酒盃
酥松=酥鬆
醋壇=醋罈
醞借=醞藉
醫藥=醫葯
釀制=釀製
重制=重製
重復=重覆
重折=重摺
金發=金髮
金表=金錶
金裝玉裏=金裝玉裡
銀朱=銀硃
銀發=銀髮
銅制=銅製
銹病=鏽病
銹菌=鏽菌
銹蝕=鏽蝕
鋁制=鋁製
鋼制=鋼製
錄制=錄製
鐘表=鐘錶
鐵銹=鐵鏽
長發=長髮
長須鯨=長鬚鯨
門裏=門裡
閃存=快閃記憶體
開誠佈公=開誠布公
閒情逸緻=閒情逸致
間不容發=間不容髮
關系=關係
關系著=關係著
防臺=防颱
防銹=防鏽
阿裏=阿裡
除舊布新=除舊佈新
陰歷=陰曆
陽春面=陽春麵
陽歷=陽曆
雅致=雅緻
雙折=雙摺
雞只=雞隻
雞絲面=雞絲麵
雞腿面=雞腿麵
難舍=難捨
雪糕=冰淇淋
雪裏=雪裡
雲須=雲鬚
電子表=電子錶
電復=電覆
電沖=電衝
電表=電錶
霧裏=霧裡
面價=麵價
面包=麵包
面團=麵團
面店=麵店
面廠=麵廠
面攤=麵攤
面杖=麵杖
面條=麵條
面灰=麵灰
面皮=麵皮
面筋=麵筋
面粉=麵粉
面糊=麵糊
面線=麵線
面茶=麵茶
面食=麵食
面餃=麵餃
面餅=麵餅
鞋裏=鞋裡
鞣制=鞣製
鞭辟入裏=鞭辟入裡
韓制=韓製
韓國制=韓國製
須根=鬚根
須毛=鬚毛
須生=鬚生
須發=鬚髮
須眉=鬚眉
須須=鬚鬚
頌系=頌繫
預制=預製
頒布=頒佈
頭球=頭槌
頭發=頭髮
頭裏=頭裡
頰須=頰鬚
顛復=顛覆
風裏=風裡
飯團=飯糰
餛飩面=餛飩麵
首當其沖=首當其衝
馬表=馬錶
馬裏=馬利
騰沖=騰衝
骨灰壇=骨灰罈
骯臟=骯髒
髭須=髭鬚
鬅松=鬅鬆
鬈發=鬈髮
鬢發=鬢髮
魚松=魚鬆
鮎魚=鯰魚
鯨須=鯨鬚
鶴發=鶴髮
鹵制=滷製
鹵面=滷麵
麻醬面=麻醬麵
黃歷=黃曆
黃發=黃髮
黑松=黑鬆
黑發=黑髮
默認=預設
鼓裏=鼓裡
鼠標=滑鼠
龍須=龍鬚
#成語
一樹百獲=一樹百穫
一發千鈞=一髮千鈞
不識臺舉=不識抬舉
不識檯舉=不識抬舉
舍己從人=捨己從人
舍己救人=捨己救人
舍己為人=捨己為人
舍己為公=捨己為公
舍己為國=捨己為國
舍我其誰=捨我其誰
舍本逐末=捨本逐末
舍死忘生=捨死忘生
舍短取長=捨短取長
舍車保帥=捨車保帥
舍近求遠=捨近求遠
魂牽夢系=魂牽夢縈
鴻篇巨制=鴻篇巨製
明窗凈幾=明窗淨幾
星羅棋佈=星羅棋布
#鳥毅加
體內=體內
內存=記憶體
激活=啟動
家夥=傢伙
家火=傢伙
家伙=傢伙
恢複=恢復
報道=報導
文身=紋身
咨=諮
污=汙
土豆=馬鈴薯
#牛人=神人
#人名、品名
克林頓=柯林頓
墨索裏尼=墨索裡尼
薩達姆=海珊
布什=布希
戴安娜=黛安娜
萊索托=賴索托
萬事得=馬自達
#地名、國名
#朝鮮=北韓 #不過度翻譯
#韓國=南韓 #不過度翻譯
克羅地亞=克羅埃西亞
阿塞拜疆=亞塞拜然
阿拉伯聯合酋長國=阿拉伯聯合大公國
也門=葉門
贊比亞=尚比亞
列支敦士登=列支敦斯登
利比裏亞=賴比瑞亞
伯利茲=貝裏斯
危地馬拉=瓜地馬拉
馬爾代夫=馬爾地夫
馬耳他=馬爾他
土庫曼斯坦=土庫曼
博茨瓦納=波劄那
卡塔爾=卡達
莫桑比克=莫三比克
加納=迦納
沙地阿拉伯=沙烏地阿拉伯
沙特阿拉伯=沙烏地阿拉伯
哈薩克斯坦=哈薩克
哥斯達黎加=哥斯大黎加
多明尼加共和國=多明尼加
多明尼加聯邦=多米尼克
多米尼加=多明尼加
多米尼加聯邦=多米尼克
基裏巴斯=吉裏巴斯
塔吉克斯坦=塔吉克
塞拉利昂=獅子山
塞浦路斯=塞普勒斯
塞舌爾=塞席爾
吉布堤=吉布地
吉布提=吉布地
安提瓜和巴布達=安地卡及巴布達
尼克松=尼克鬆
尼日利亞=奈及利亞
尼日爾=尼日
巴巴多斯=巴貝多
巴布亞新幾內亞=巴布亞紐幾內亞
巴布亞新畿內亞=巴布亞紐幾內亞
布基納法索=布吉納法索
幾內亞比紹=幾內亞比索
意大利=義大利
所羅門群島=索羅門群島
新西蘭=紐西蘭
文萊=汶萊
斯威士蘭=史瓦濟蘭
斯洛文尼亞=斯洛維尼亞
斯裏蘭卡=斯裡蘭卡
波斯尼亞和黑塞哥維那=波士尼亞赫塞哥維納
波斯尼亞黑塞哥維那=波士尼亞赫塞哥維納
津巴布韋=辛巴威
洪都拉斯=宏都拉斯
溫納圖萬=那杜
烏茲別克斯坦=烏茲別克
聖吉斯納域斯=聖克裏斯多福及尼維斯
聖基茨和尼維斯=聖克裏斯多福及尼維斯
聖文森特和格林納丁斯=聖文森及格瑞那丁
聖盧西亞=聖露西亞
聖馬力諾=聖馬利諾
索馬裏=索馬利亞
肯尼亞=肯亞
肯雅=肯亞
註意=注意
